{
  "sizeX": 25,
  "sizeY": 25,

  "startX": 0,
  "startY":12,



  "maze": [
    "############ ############",
    "#0   # 0#       #   #0#0#",
    "## #   ## ## ## #0#     #",
    "#  ### #0 # 0#0 ##### # #",
    "#  0#   #  # ## #0#   # #",
    "## ## # ##        # #   #",
    "#0 #  #0## #### # #0# ###",
    "## #0####  0#0  # ###  0#",
    "#  ### 0# #### ##   ## ##",
    "# ##0# ##    #  #0# 0#  #",
    "#      ##  #  # ### ### #",
    "# #### 0# ## ## 0#0 #0  #",
    "# 0#   ##     # ### ### #",
    "# ## #  #0# # #  #0 #   #",
    "#    # ###  # ## #### ###",
    "###0#0   # ###0#      #0#",
    "#0#### # # #   ######   #",
    "#      #   # #0# 0#0# # #",
    "## ## #####   ## ## # #0#",
    "#     #0#   #       # ###",
    "# #####   ##### ## ##   #",
    "# #000#0###0 0###   0## #",
    "# ### #0#   0  0# # #   #",
    "#     #000#0 0#0#0#   #0#",
    "############g############"
  ]


}